1111111111111
1E0P0000000C1
1111111111111
