11111111111111111111111111111
1E1000000000000C00100C0000001
1P100101001000001010010000001
10100100101010100010010000001
100010000C00C000000000C000001
1111C000111100110000111000001
100000000000000C11111C0000011
11111111111111111111111111111
