111111111
111P0E0C4
111111111
