1111111111111
10C10000001C1
1010011111011
1P0011E000001
1111111111111
