1111111111111111111111111111111111
10000000I000000C00000CI000E0000001
1P10010100100000101001000000010101
1010010010101010001001000010010101
10100100101010100010010000I0010101
10000I000C00C000000000000000000IC1
10000000000000000C000000I000I00001
1C0000I0000100010000I00000C0000001
1111111111111111111111111111111111
